NO           ./textures/li/eg1.xpm

F    0,0,0

WE      ./textures/li/eg6.xpm
SO                                ./textures/li/eg4.xpm
EA ./textures/li/eg5.xpm
C  36,26,0











11111111111111111111111111111111111111111111111111111111111111111
1000000000000000000D000000000000000000000000000000000000000000001
111111111111111111111111111D1111111111111111111111111111111111111
                          101
                          101
                          101
                          101
                          101                                                               1111
111111111111111111111111111D11111111111111111111111111111111111111                           1001
10000000000D000000110000000000000000000000000000000000000000000001                            1001
1000000000110000011100000000000011111111111D1111111111111111111D11                             1001
1000000000010000000D0000000000001       100001               1001                               1001
111111111D11000001110000000000001      10011001             1001                                 1001
10000000001100000111D111111D11111     1001  1001           1001                                   1001
1111D111111111011 100000000W01       1001    1001         1001                                     1001
1111D1111111110111101000000001      1001      1001       1001                                       1001
10000000000000000D000010000001     1001        1001     1001                                         1001
1000000000000000010001000100001   1001          1001   1001                                           1001
10000000000000011110001000000101 1001            1001 1001                                             1001
11000001110101001 101010100001001001              1001001                                               1001
11110111 1110101 100000000000000D01                10001                                                 1001
11111111 111D111 11111111111111111                  111                                                   1001
           101                                                                                             1001
           101                                                                                              1001
           101                                                                                               1001
           101                                                                                                1001
           101                                                                                                 1001
           101                                                                                                  1001
           1011111111111111111111111111111111111111111111111111111111111111111111111111111111111111111111111111111001
           10D000000000000000000000000000000000000000000000000000000000000000000000000000000000000000000000000000D0001
           11111111111111111111111111111111111111111111111111111111111111111111111111111111111111111111111111111111111







